ace=eɪs
afraid=ə'freɪd
afraid=ə'freɪd
afraid=ə'freɪd
airplane='ɜr,pleɪn
ambulance='æmbjələns
angry='æŋgri
ankle='æŋkəl
ape=eɪp
arm=ɑrm
armadillo=,ɑrmə'dɪl_oʊ
astronaut='æstrə,nɔt
axe=æks
baby='beɪbi
badminton racquet='bædmɪntən_'rækɪt
bake=beɪk
balance beam='bæləns_bim
balance beam='bæləns_bim
balance='bæləns
ball=bɔl
ballet slippers=bæ'leɪ_slɪpərz
balloon=bə'lun
bandage='bændɪdʒ
barn=bɑrn
barnyard='bɑrn,jɑrd
basket='bæskɪt
basketball='bæskɪt,bɔl
bat=bæt
beagle='biɡəl
beagle='biɡəl
beanie cap=bini_kæp
beaver='bivər
bed=bɛd
bell=bɛl
binoculars=bɪ'nɑkjuləz
bird=bɜrd
birthday cake='bɜrθ,deɪ_keɪk
blackberries='blæk,bɛriz
blanket='blæŋkɪt
blew=blu
bloodhound='bləd,haʊnd
blouse=blaʊs
blouse=blaʊs
blue=blu
boat trailer=boʊt_treɪlər
boat=boʊt
book=bʊk
bookcase='bʊk,keɪs
boots=butz
bow and arrows=baʊ_ænd_'æroʊz
bow tie=baʊ_taɪ
bowl=boʊl
boxer='bɑksər
boy=bɔɪ
boyfriend='bɔɪ,frɛnd
boys=bɔɪz
break=breɪk
bride=braɪd
bridge=brɪdʒ
broom=brum
brother='brəðər
brother='brəðər
brown=braʊn
brown=braʊn
brush=brəʃ
bubble='bəbəl
bucket='bəkɪt
bug=bəɡ
bull=bʊl
bulldog='bʊl,dɔɡ
bunk bed=bəŋk_bɛd
bunny='bəni
burn=bɜrn
bus=bəs
butterflies='bʌtɝr,flaɪz
butterfly='bətər,flaɪ
cactus='kæktəs
cake=keɪk
calculator='kælkjə,leɪtər
camel='kæməl
canary=kə'nɜri
candlestick='kændəl,stɪk
candy='kɑndi
canoe=kə'nu
car=kɑr
carpenter's square=‘kɑrpəntərz_skwɜr
carpet='kɑrpɪt
cashew='kæʃu
cat=kæt
catch=kætʃ
catcher='kætʃər
caught=kɑt
cauldron='kɔldrən
celery='sɛləri
chainsaw=tʃeɪn'sɔ
chair=tʃɜr
chimney='tʃɪmni
chipmunk='tʃɪpmənk
circle='sɜrkəl
clam=klæm
clarinet=,klærə'nɛt
claw hammer=klɔ_'hæmər
claw hammer=klɔ_'hæmər
cleats=klits
climb=klaɪm
clothes=kloʊz
cloud=klaʊd
cloudy='klaʊdi
clown=klaʊn
coat=koʊt
coin=kɔɪn
cold=koʊld
collie='kɑli
convertible=kən'vɜrtəbəl
convertible=kən'vɜrtəbəl
convertible=kən'vɜrtəbəl
cookies=kʊkiz
coonskin cap='kun,skɪn_kæp
coonskin cap='kun,skɪn_kæp
corn=kɔrn
cow=kaʊ
cowboy='kaʊ,bɔɪ
crab=kræb
cradle='kreɪdəl
cranberries=krænbɛri
crane=kreɪn
crayon='kreɪɑn
crayons=kreɪɑnz
cries=kraɪz
crook='krʊk
crooked='krʊkɪd
crowbar='kroʊ,bɑr
cry=kraɪ
cucumber='kjukəmbər
curl=kɜrl
cushion='kʊʃən
cut=kət
dachshund='dæks,hʊnd
dancing='dænsɪŋ
dandelion='dæn,dəlaɪən
dark=dɑrk
daughter='dɔtər
daybreak='deɪ,breɪk
daydreaming='deɪ,drimɪŋ
desk=dɛsk
diesel truck='dizəl_trək
dig=dɪɡ
dish=dɪʃ
diving='daɪvɪŋ
dog=dɔɡ
dogs=dɑɡz
doll house=dɑl_haʊs
dozer='doʊzər
draw=drɔ
drill=drɪl
drink=drɪŋk
drop=drɑp
drum=drəm
dune buggy=dun_'bəɡi
eagle='iɡəl
eat=it
elf=ɛlf
excavator='ɛkskə,veɪtər
excavator='ɛkskə,veɪtər
excavator='ɛkskə,veɪtər
excavator='ɛkskə,veɪtər
eyebrow='aɪ,braʊ
eyebrow='aɪ,braʊ
eyebrow='aɪ,braʊ
eyelash='aɪ,læʃ
eyelash='aɪ,læʃ
face=feɪs
fall=fɔl
family='fæməli
father='fɑðər
faucet='fɔsɪt
feather='fɛðər
fencing foil='fɛnsɪŋ_fɔɪl
fiddle='fɪdəl
fight=faɪt
finger='fɪŋɡər
fireplug='faɪər,pləɡ
firetruck=faɪər,trək
fish=fɪʃ
fishing net='fɪʃɪŋ_nɛt
fishing='fɪʃɪŋ
five-point-star=faɪv_pɔɪnt_stɑr
five=faɪv
flag=flæɡ
flame=fleɪm
flashlight='flæʃ,laɪt
flashlight='flæʃ,laɪt
flew=flu
flies=flaɪz
flight=flaɪt
flower='flaʊər
flute=flut
fly=flaɪ
flying carpet='flaɪɪŋ_kɑrpɪt
flying squirrel='flaɪɪŋ_'skwɜrəl
flying squirrel='flaɪɪŋ_'skwɜrəl
foot=fʊt
football='fʊt,bɔl
footstool='fʊt,stul
forest='fɔrɪst
fork=fɔrk
four-leaf clover=foʊr_lif_'kloʊvər
fox=fɑks
fridge=frɪdʒ
frightened='fraɪtənd
fringe=frɪndʒ
frisbee='frizbi
frisbee='frizbi
frog pads=frɑɡ_pædz
frog=frɑɡ
front loader=frənt_loʊdər
fruits=frutz
frying pan=fraɪɪŋ_pæn
furniture='fɜrnətʃər
garden='ɡɑrdən
gazelle=ɡə'zɛl
gazelle=ɡə'zɛl
gingerbread man='dʒɪndʒər,brɛd_mɑn
giraffe=dʒə'ræf
girl=ɡɜrl
glass=glæs
globe=gloʊb
glove=gləv
gloves=gləv
glow=gloʊ
glum=gləm
goat=ɡoʊt
gold=ɡoʊld
golf club=ɡɑlf_kləb
goose=ɡus
grandfather clock='græn,fɑðər_klɑk
grandfather clock='græn,fɑðər_klɑk
grandfather='græn,fɑðər
grandfather='græn,fɑðər
grandmother='græn,məðər
grandmother='græn,məðər
grandmother='græn,məðər
grape=greɪp
grapes=greɪpz
grass=græs
grasshopper='græs,hɑpər
green beans=grin_binz
greyhound='greɪ'haʊnd
grizzly bear='grɪzli_bɜr
grizzly bear='grɪzli_bɜr
groceries='ɡroʊsɝriz
guinea pig='ɡɪni_pɪɡ
guitar player=ɡɪ'tɑr_pleɪər
hamburger='hæm,bɜrgər
hamster='hæmstər
hand=hænd
hard hat=hɑrd_hæt
hat=hæt
hatchet='hætʃɪt
haul=hɔl
hawk=hɔk
hazelnuts='heɪzəl,nət
hedge clippers=hɛdʒ_'klɪpɝrz
hexagon='hɛksə,ɡɑn
hexagon='hɛksə,ɡɑn
hilly='hɪli
hit=hɪt
horn=hɔrn
hornet='hɔrnɪt
horse=hɔrs
hot=hɑt
housefly='haʊs,flaɪ
hug=həɡ
ice cream=aɪs_krim
ice cream=aɪs_krim
ice cream=aɪs_krim
ice cream=aɪs_krim
ice=aɪs
jack in the box=dʒæk_ɪn_ðʌ_bɑks
jay=dʒeɪ
jeep=dʒip
jelly-jars=ˈʤɛli ʤɑː
jellyfish='dʒɛli,fɪʃ
jewelry='dʒuəlri
joy=dʒɔɪ
judge=dʒədʒ
judge=dʒədʒ
juggler='dʒəglər
jump=dʒəmp
kangaroo=,kæŋɡə'ru
kayak='kaɪæk
key=ki
king=kɪŋ
kitten='kɪtən
labrador retriever='læbrə,dɔr_rɪ'trivər
laundress='lɔndrɪs
laundress='lɔndrɪs
lawnmower='lɔnmoʊɝr
leaf=lif
life jacket=laɪf_'dʒækɪt
light=laɪt
light=laɪt
light=laɪt
lightning='laɪtnɪŋ
lightning='laɪtnɪŋ
lion='liɔn
lizard='lɪzərd
long sleeve shirt=lɔŋ_sliv_ʃɜrt
love=ləv
macaw parrot=mə'kɑ_'pærət
mailman='meɪl,mæn
man=mɑn
mask of frog=mæsk_ʌv_frɑɡ
mittens='mɪtɛnz
mole=moʊl
monkey bars=məŋki_bɑrz
monkey wrench='məŋki_rɛntʃ
monkey wrench='məŋki_rɛntʃ
monkey='məŋki
moon=mun
moth=mɔθ
mother='məðər
mountain='maʊntən
mouse=maʊs
mouth='maʊθ
music='mjuzɪk
nail=neɪl
net=nɛt
night=naɪt
nightgown='naɪtgæʊn
noise=nɔɪz
nose=noʊz
nun=nun
nuts=nəts
old=oʊld
onion='ənjən
ostrich='ɑstrɪtʃ
oven='əvən
owl=aʊl
oyster='ɔɪstər
paint=peɪnt
panda='pændə
path=pæθ
pearl=pɜrl
peas=piz
pencil='pɛnsəl
penguin='pɛŋwɪn
pet=pɛt
pie man=paɪ_mɑn
pie=paɪ
pig=pɪɡ
pink=pɪŋk
pinky finger='pɪŋki_'fɪŋɡər
playground='pleɪ,graʊnd
plug=pləɡ
plum=pləm
plum=pləm
poison='pɔɪzən
polar bear='poʊlər_bɜr
poodle='pudəl
popcorn='pɑp,kɔrn
pot=pɑt
present='prɛzənt
pretzel='prɛtsəl
proposing=prʌ'poʊzɪŋ
proud=praʊd
puppy='pəpi
purple='pɜrpəl
purse=pɜrs
queen=kwin
question='kwɛstʃən
quiet='kwaɪɪt
quiet='kwaɪɪt
quiet='kwaɪɪt
rabbit='ræbɪt
raccoon=ræ'kun
raccoons=ræ'kunz
rainbow='reɪn,boʊ
rake=reɪk
robot='roʊbət
rocket='rɑkɪt
royal='rɔɪəl
rug=rəɡ
saddle='sædəl
saint bernard=seɪnt_bɛR'nAR
sandal='sændəl
sandbox='sænd,bɑks
sandwich='sændwɪtʃ
sauce pan=sɔs_pæn
saw=sɔ
scarf=skɑrf
school bus=skul_bəs
schoolbus=skulbəs
scratch=skrætʃ
screws=skru
seagulls='siɡəlz
see saw=si_sɔ
sheep=ʃip
shirt=ʃɜrt
shoes=ʃuz
shovel='ʃəvəl
shower='ʃaʊər
silly='sɪli
silver='sɪlvər
sing=sɪŋ
sit=sɪt
six-point-star=sɪks_pɔɪnt_stɑr
six=sɪks
sixteen='sɪks'tin
sixty='sɪksti
skate=skeɪt
skateboard='skeɪt,boʊrd
skip=skɪp
skirt=skɜrt
skis=skiz
skunk=skəŋk
sky=skaɪ
sled=slɛd
sledge hammer=slɛdʒ_'hæmər
sleepy dog='slipi_dɔɡ
sleepy='slipi
slide=slaɪd
slippers='slɪpərz
snail=sneɪl
snake=sneɪk
snow plow=snoʊ_plaʊ
snow=snoʊ
soap=soʊp
soccer goal=sɑkər_ɡoʊl
sofa='soʊfə
sombrero=sɑm'brɜroʊ
spider='spaɪdər
spies=spaɪz
spill=spɪl
spoon=spun
spray=spreɪ
sprinkler='sprɪŋklər
spyglass='spaɪglɑs
square=skwɜr
squash=skwɑʃ
squirrel='skwɜrəl
star=stɑr
starfish='stɑr,fɪʃ
statue='stætʃu
steal=stil
stew pot=stu
stilts=stɪltz
stir=stɜr
stool=stul
stool=stul
storm=stɔrm
straw=strɔ
straw=strɔ
strawberries=strɑbəriz
street sweeper=strit_'swiɛr
street sweeper=strit_'swiɛr
suit=sut
suitcase='sut,keɪs
sunglasses='sʌn,ɡlæsɪz
surfboard='sɜrf,boʊrd
SUV=ɛs'ju'vi
swan=swɑn
sweet potato=swit_pə'teɪtoʊ
sweet=swit
swim=swɪm
swimming='swɪmɪŋ
swing=swɪŋ
syringe=sə'rɪndʒ
t-square=ti_skwɜr
table='teɪbəl
tail=teɪl
tank truck=tæŋk_trək
tank=tæŋk
tape measure=teɪp_'mɛʒər
taxi='tæksi
teapot='ti,pɑt
teeter-totter='titər_,tɑtər
tennis racquet='tɛnɪs_'rækɪt
tetherball='tɛðər,bɔl
thirsty='θɜrsti
thirteen=θɜr_'tin
thirty='θɜrti
three=θri
threw=θru
throat=θroʊt
throat=θroʊt
throne=θroʊn
throw=θroʊ
throw=θroʊ
thumb=θəm
tie=taɪ
tissue='tɪʃu
toaster='toʊstər
toaster='toʊstər
toe=toʊ
toilet paper='tɔɪlɪt_'peɪpər
toilet='tɔɪlɪt
tool belt=tul_bɛlt
tortilla=tɔr'tiə
town=taʊn
toys=toʊjz
traffic light='træfɪk_laɪt
tree stump=tri_stəmp
tree=tri
triangle='traɪ,æŋɡəl
tricycle='traɪsɪkəl
troll=troʊl
trolley='trɑli
trombone=trɑm'boʊn
troubles='trəbəlz
troubles=trəbəlz
trowel hat='traʊəl_hæt
trowel='traʊəl
truck=trək
trumpet='trəmpɪt
tuba='tubə
tumble='təmbəl
turkey='tɜrki
turtle='tɜrtəl
umbrellas=əm'brɛlə
unicycle='junɪ,saɪkəl
unicorn='junɪkɔrn
utility knife=ju'tɪlɪti_naɪf
van=vɑn
volcano=vɑl'keɪnoʊ
wagon='wæɡən
wall=wɔl
walnuts='wɔl,nət
walrus='wɔlrəs
wash=wɑʃ
wasp=wɑsp
waterfall='wɔtər,fɔl
watermelon='wɔtər,mɛlən
weather='wɛðər
weather='wɛðər
wedding gown='wɛdɪŋ_gaʊn
whale=hweɪl
wheel=hwil
wheelbarrow='wil,bæroʊ
wheelchair='hwil,tʃɜr
whisper='hwɪspər
whistle='hwɪsəl
white calf=hwaɪt_kæf
white cat=hwaɪt_kæt
white spider=hwaɪt_'spaɪdər
wig=wɪɡ
window='wɪndoʊ
wolf=wʊlf
woman='wʊmən
wood=wʊd
work=wɜrk
xylophone='zaɪlə,foʊn
yacht=jɑt
yawn=jɔn
yawn=jɔn
yellow='jɛloʊƒ
yo-yo='joʊ_joʊ
zebra='zɛbrə
zipper='zɪpər
zoo=zu
